################
#S.....#.......#
#.###..#..###..#
#......#.......#
#..##......##G.#
################

